0 0 0 0 0 0 0 0 4 0
0 0 0 0 0 0 0 0 1 0
0 0 0 0 0 0 0 0 1 0
0 0 0 0 0 0 0 0 1 0
0 0 0 0 0 0 0 0 1 0
-1 -1 -1 -1 -1 -1 -1 -1 2 -1
-1 -1 -1 -1 -1 -1 -1 -1 2 -1
-1 -1 -1 -1 -1 -1 -1 -1 2 -1
-1 -1 -1 -1 -1 -1 -1 -1 2 -1
-1 -1 -1 -1 -1 -1 -1 -1 2 -1
-1 2.4 2.0 2.0 2.2 -1 -1 -1 2 -1
-1 2 -1 -1 2 -1 -1 -1 2 -1
-1 2 -1 -1 2 -1 -1 -1 2 -1
-1 2 -1 -1 2 -1 -1 -1 2 -1
-1 2 -1 -1 2 -1 -1 -1 2 -1
-1 2.3 2.0 2.0 2.1 2.0 2.0 2.0 2.5 -1
-1 -1 -1 -1 2 -1 -1 -1 -1 -1
-1 -1 -1 -1 2 -1 -1 -1 -1 -1
-1 -1 -1 -1 2 -1 -1 -1 -1 -1
-1 -1 -1 -1 2 -1 -1 -1 -1 -1
-1 -1 -1 -1 2 -1 -1 -1 -1 -1
-1 -1 -1 -1 2 -1 -1 -1 -1 -1
-1 -1 -1 -1 2 -1 -1 -1 -1 -1
0 0 0 0 1 0 0 0 0 0
0 0 0 0 1 0 0 0 0 0
0 0 0 0 1 0 0 0 0 0
0 1 0 0 1 0 0 0 0 0
0 1 0 0 1 0 0 0 0 0
0 1 0 0 1 1 1 1 0 0
0 1 0 0 0 0 0 1 0 0
0 1 0 0 0 0 0 1 0 0
0 1 1 1 1 0 0 1 0 0
0 1 0 0 1 0 0 1 0 0
0 1 0 0 1 0 0 1 0 0
0 1 0 0 1 0 0 1 0 0
0 1 0 0 1 0 0 1 0 0
0 1 1 1 1 1 1 1 0 0
0 0 1 0 1 0 0 1 0 0
0 0 1 0 1 0 0 1 0 0
0 0 1 0 1 0 0 1 0 0
0 0 1 1 1 1 1 1 0 0
0 0 0 0 1 0 0 0 0 0
0 0 0 0 1 0 0 0 0 0
-1 -1 -1 -1 2 -1 -1 -1 -1 -1
-1 -1 -1 -1 2 -1 -1 -1 -1 -1
-1 -1 -1 -1 2 -1 -1 -1 -1 -1
-1 -1 -1 -1 2 -1 -1 -1 -1 -1
-1 -1 -1 -1 2 -1 -1 -1 -1 -1
-1 -1 -1 -1 2 -1 -1 -1 -1 -1
-1 -1 -1 -1 2 -1 -1 -1 -1 -1
-1 -1 -1 -1 2 -1 -1 -1 -1 -1
-1 -1 -1 -1 2 -1 -1 -1 -1 -1
-1 -1 -1 -1 2 -1 -1 -1 -1 -1
0 0 0 0 1 0 0 0 0 0
0 0 0 0 1 0 0 0 0 0
0 0 0 0 1 0 0 0 0 0
0 0 0 0 1 0 0 0 0 0
0 0 0 0 1 0 0 0 0 0
0 0 0 0 1 1 1 0 0 0
0 0 0 0 0 0 1 0 0 0
0 0 0 0 0 0 1 0 0 0
0 0 0 3 1 1 1 0 0 0
0 0 0 0 0 0 0 0 0 0
0 0 0 0 0 0 0 0 0 0